CCCCCCCCCCCCCCCCCCCCCCCCCCCCCCCC
e     C C   C       C         CC
C CcCCC C CCC C CCCCCCC C CCC CC
C C   C     C C C     C C   C CC
C C C CCCCC C CCC CCCCC CCCCC CC
C   c           C C C   C   C CC
CCCCCCCcCCCCC CCC C C C C C C CC
C     C               C   C C CC
C C C CCCCC C C CCCCCCCCCCC CCCC
C C C C     C C         C C   CC
C C CCCCCCC C C CCCCCCCCC CCC CC
C C     C   C C C C   C C     CC
C C CCC CCC C CCC C CCC C CCCCCC
C C C   C C C C         C     CC
C CCC CCC C C CCCCCCC CCCCCCC CC
C C C C     c   C         C   CC
C C C CCCCCCCCC CCCCCCC CCC CCCC
C   C       C     C2     1C C CC
CCCCC C C C CCCCC CCCCC CCCCC CC
C C   C C C C   C         C   CC
C CCCCCCCCC C C CCCCC CCCCCCC CC
C   C     C C C C       C   C CC
C CCC C CCC C CCCCC CCC C CCC CC
C C   C     C   C   C C6    C CC
C CCCCC CCC CCC CCCCC          C
C   C C   C   C C        5     C
C CCC CCCCCCC C C      3       C
C   C C C     C            4   C
CCC C C C C C CCC          s   C
C         C C                3  
CCCCCCCCCCCCCCCCCCCCC          C
CCCCCCCCCCCCCCCCCCCCCCCCCCCCCCCC
