AAAAAAAAAAAAAAAAAAAAAAAAAAAAAAAA
3     A A   A       A         AA
A AaAAA A AAA A AAAAAAA A AAA AA
A A   A     A A A     A A   A AA
A A A AAAAA A AAA AAAAA AAAAA AA
A   a           A A A   A   A AA
AAAAAAAaAAAAA AAA A A A A A A AA
A     A               A   A A AA
A A A AAAAA A A AAAAAAAAAAA AAAA
A A A A     A A         A A   AA
A A AAAAAAA A A AAAAAAAAA AAA AA
A A     A   A A A A   A A     AA
A A AAA AAA A AAA A AAA A AAAAAA
A A A   A A A A         A     AA
A AAA AAA A A AAAAAAA AAAAAAA AA
A A A A     a   A         A   AA
A A A AAAAAAAAA AAAAAAA AAA AAAA
A   A       A     A       A A AA
AAAAA A A A AAAAA AAAAA AAAAA AA
A A   A A A A   A         A   AA
A AAAAAAAAA A A AAAAA AAAAAAA AA
A   A     A A A A       A   A AA
A AAA A AAA A AAAAA AAA A AAA AA
A A   A     A   A   A A     A AA
A AAAAA AAA AAA AAAAA A A AAA AA
A   A A   A   A A     A A     AA
A AAA AAAAAAA A A A AAA AAA AAAA
A   A A A     A   A A A A A-AAAA
AAA A A A A A AAA AAA A A A   AA
A         A A             a   4s
AAAAAAAAAAAAAAAAAAAAAAAAAAAAAAAA
AAAAAAAAAAAAAAAAAAAAAAAAAAAAAAAA
