BAAAAAAAAAAAAAAAAAAAAAAAAAAAAAAA
3     B A   A       A         AA
B A2AAA A AAA A AAAAAAA A AAA AA
B A   A     A A A     A A   A AA
B A A AAAAA A AAA AAAAA AAAAA AA
B   2           A A A   A   A AA
BAAAAAA2AAAAA AAA A A A A A A AA
B     A               A   A A AA
B A A AAAAA A A AAAAAAAAAAA AAAA
B A A A     A A         A A   AA
B A AAAAAAA A A AAAAAAAAA AAA AA
B A     A   A A A A   A A     AA
B A AAA AAA A AAA A AAA A AAAAAA
B A A   A A A A         A     AA
B AAA AAA A A AAAAAAA AAAAAAA AA
B A A A     2   A         A   AA
B A A AAAAAAAAA AAAAAAA AAA AAAA
B   A       A     A       A A AA
BAAAA A A A AAAAA AAAAA AAAAA AA
B A   A A A A   A         A   AA
B AAAAAAAAA A A AAAAA AAAAAAA AA
B   A     A A A A       A   A AA
B AAA A AAA A AAAAA AAA A AAA AA
B A   A     A   A   A A     A AA
B AAAAA AAA AAA AAAAA A A AAA AA
B   A A   A   A A     A A     AA
B AAA AAAAAAA A A A AAA AAA AAAA
B   A A A     A   A A A A A   AA
AAA A A A A A AAA AAA A A AAA AA
A                             4s
AAAAABBBBBBBBBCCCCCCCCCCDDDDDDDD
AAAAAAAAAAAAAAAAAAAAAAAAAAAAAAAA
