s          --------------       
           -            -       
          -              -      
          -              -      
          -              -      
          -              -      
          -              -      
          -              -      
          -              -      
          -              -      
          -              -      
          -              -      
          -              -      
          -              -      
          -              -      
          -              -      
          -              -      
          --             -      
          --             -      
          --             -      
          --             -      
          --             -      
          --             -      
          --             -      
          --             -      
          --        ---- -      
          --           - -      
          -------------- -      
          ----------------      
          ----------------      
          ----------------      
           --------------       
