CCCCCCCCCCCCCCDDDDDDDDDDD      D
C333CCCCCC   CDDD     D   DDDD D
C343-  c   s CDeD D D D D    D D
C3 3CCCC C   CD-DDD D D DDDDDD D
CCcCC  C CCCCCD     D   D   D  D
CC C   C C    DDDDDDDDDDD DDD DD
CC CCCCC CCCCCCCCCBBBBBBD 3 D  D
CC c             CB    BD D DD D
CCCC   C CCC C   CB BB BD D D  D
CCCC CCC  3  CCC  - BB BDDD DD D
CCCC   C CCC C   CB BB BD   D  D
CCCC             CB    BD DDD DD
CCCCCCCCCCCCCCCCCCBBBB BD D    D
BBBBBBBBBBBBBBBBBB   b BD D DD D
BBB              BBBBB BD D  D D
BBB3BBBBBBBBBBBB       BD DDDD D
BBB              BBBBBBBD D    D
BBB BBBBBBBBBBBBBBBBBBDDD D DDDD
AAA-ABBBBBBBBBBBBBBBBBD     D  D
AAA  ABBBBBBBBBBBBBBBBDDDD DDD D
AAAA  ABBBBBBBBBBBBBBBD    D   D
AAAAA  ABBBBBBBBBBBBBBD DDDD D D
AAAAAA  ABBBBBBBBBBBBBD      D D
AAAAAAA  ABBBBBBBBBBBBD DD DDD D
AAAAAAAA  ABBBBBBBBBBBD  D     D
AAAAAAAAA  ABBBBBBBBBBDDDDDDD-DD
AAAAAAAAAA  AAAAAAAAAAAAAAAAA AA
AAAAAAAAAAA    A   A   A   A   A
AAAAAAAAAAAA A   A   A   A A   A
AAAAAAAAAAAAAAAAAAAAAAAAAA A   A
AAAAAAAAAAAAAAAAAAAAAAAAAA     A
AAAAAAAAAAAAAAAAAAAAAAAAAAAAAAAA
