CCCCCCCCCCCCCCDDDDDDDDDDD      D
C111CCCCCC   CDDD     D   DDDD D
C121-  c   s CDeD D D D D    D D
C1 1CCCC C   CD-DDD D D DDDDDD D
CCcCC  C CCCCCD     D   D   D  D
CC C   C C    DDDDDDDDDDD DDD DD
CC CCCCC CCCCCCCCCBBBBBBD 1 D  D
CC c             CB    BD D DD D
CCCC   C CCC C   CB BB BD D D  D
CCCC CCC  1  CCC  - BB BDDD DD D
CCCC   C CCC C   CB BB BD   D  D
CCCC             CB    BD DDD DD
CCCCCCCCCCCCCCCCCCBBBB BD D    D
BBBBBBBBBBBBBBBBBB   b BD D DD D
BBB              BBBBB BD D  D D
BBB1BBBBBBBBBBBB       BD DDDD D
BBB              BBBBBBBD D    D
BBB BBBBBBBBBBBBBBBBBBDDD D DDDD
AAA-ABBB -           BD     D  D
AAA  A   bBBBBBBB  B BDDDD DDD D
AAAA  aB -       B1B BD    D   D
A   A  ABbB BBBB- B1BBD DDDD D D
A 1 AA  AB  B  B     BD      D D
A   aaa  AB  B B B B BD DD DDD D
A AAAAAA  AB     B   BD  D     D
A -a  1AA  ABBBBBBBBBBDDDDDDD-DD
A AAAa AAA  AAAAAAAAAAAAAAAAA AA
A aaaa A AA    A   A   A   A   A
A AAAAA - 1a a   A   a   A A   A
A       AAAAA1AAA1AAAaAAAA A   A
AAAAAAA - aa         aaaaa     A
AAAAAAAAAAAAAAAAAAAAAAAAAAAAAAAA
